                         
             -----------p
             -           
  -----      ---         
  -   -        -         
e--   ----------         
  -   -        -         
  -----      ---         
             -           
             -----------p